NO ./path_to_the_north_texture
SO ./path_to_the_south_texture
WE ./path_to_the_west_texture
EA ./path_to_the_east_texture

F 220,100,0
C 225,30,0

MEDI ./cenas
AMMO ./tretas
ENEMY ./coisas
BULLET ./bro
GUN ./yas
DOOR ./tretas

        1111111111111111111111111
        1000000000110MMM00Z000001
        101100000111000000Z100001
        100100E00DDD00000Z1000001
111111111011000001110000000000001
10000000A011000001110111110111111
11110111111111D11100000010001
1111D111111111011101010010001
110000001101010111000Z0010001
1M000000000000001100000010001
1A00000A000000001101010Z10001
1100000111010101111101111000111
11110111 1110101 101111010001
11111111 1111111 111111111111

        