NO ./assets/xpm_north.xpm
SO ./assets/xpm_south.xpm
WE ./assets/xpm_east.xpm
EA ./assets/xpm_west.xpm

F ./assets/xpm_margarida.xpm
C ./assets/xpm_margarida.xpm


        1111111111111111111111111
        1000000000110000000000001
        1011000001110000000100001
        100100E00DDD0000001000001
111111111011000001110000000000001
100000000011000001110111110111111
11110111111111D11100000010001
11110111111111011101010010001
11000000110101011100000010001
1M000000000000001100000010001
10000000000000001101010010001
1100000111010101111101111000111
11110111 1110101 101111010001
11111111 1111111 111111111111

