NO ./assets/xpm_north.xpm
SO ./assets/xpm_south.xpm
WE ./assets/xpm_west.xpm
EA ./assets/xpm_east.xpm

F 255,0,0
C 0,255,0


        1111111111111111111111111
        1000000000110000000000001
        1011000001110000000100001
        1001000000000000001000001
111111111011000001110000000000001
100000000011000001110111110111111
11110111111111011100000010001
11110111111111011101010010001
11000000110101011100000010001
10000000000000011000000100001
10000000E00000001101010010001
1100000111010101111101111000111
11110111 1110101 101111010001
11111111 1111111 111111111111

