NO ./assets/xpm_north.xpm
SO ./assets/xpm_south.xpm
WE ./assets/xpm_east.xpm
EA ./assets/xpm_west.xpm

F ./assets/xpm_margarida.xpm
C ./assets/xpm_margarida.xpm

MEDI ./assets/xpm_medikit.xpm
AMMO ./assets/xpm_rubens_dementor.xpm
X_ENEMY ./assets/xpm_mario.xpm
Y_ENEMY ./assets/xpm_mario.xpm
Z_ENEMY ./assets/xpm_mario.xpm
MY_BULLET ./assets/xpm_flying_bullet.xpm
EN_BULLET ./assets/xpm_flying_bullet.xpm
WALL_BULLET ./assets/xpm_flying_bullet.xpm
GUN ./assets/xpm_gun.xpm
DOOR ./assets/xpm_door.xpm


11111111111111111111111111111111111111111
1E00001000100000100Z000010000000001010A01
11101010101011101011101110111011101011101
100010M010101010100010Z0M01010100ZZ000001
101011101111101D1111111010101110111111111
101Z1010100M000000100Z0010100010100A10001
10111011111111111010111110101111111010101
10101010Z010D00010100A0010ZZZ010100000101
10101A10101110111011101011111110111111101
100Z00101010000010Z0001010100010001000001
10101010111111101110111110101111101011101
101010000Z0010D00010000000000010000000101
11101010111110111010101011101110111111111
101010100000001000D0101000100000100000001
10101110111010111010101111111110101111101
10001000001010001010101000000010000010101
10111011101110101011111011101110111010101
10100010001010101000001000100010001010101
10111010101011101111101011101111101010101
10100010101000101000100000100010101010001
10111010101110101110101011111110111011101
10101010100000101000001000100010001010101
10101110101111111110101111101110101010101
10001000100010000000100010000010101010101
10101011101010101111111110111110111010111
10101010001010100000000000100000100010001
10101011111011111111111110101111111111101
10101000101000001000001000101000001000001
11101110101111111010111110101010111011111
10001000000010000010100010000010100000001
10111111111011101010101111111110111111101
10100000001000001010000010000010001010001
11101010111110111011111010111111101010101
10001010100000100000001010100000100010101
10101110101011101111101110101110111010111
10101000101010000010000010001000000010001
10101011101010111011111111111010111010101
10101000001010101000000000001010001000101
10101111111010101011101111101011101111101
10100000100010001010000000101010000000101
11111111111111111111111111111111111111111
